10
0 5
9 2
#####.####
#####.####
##......##
##.####.##
.....#....
.########.
.####.....
#####.####
##....####
##.#######